X 21 Y 11
X 21 Y 10
X 21 Y 9
X 20 Y 9
X 19 Y 9
X 18 Y 9
X 17 Y 9
X 16 Y 9
X 16 Y 8
X 16 Y 7
X 15 Y 7
X 14 Y 7
X 13 Y 7
X 13 Y 6
X 13 Y 5
X 13 Y 4
X 12 Y 4
