X 2 Y 32
X 3 Y 32
X 4 Y 32
X 5 Y 32
X 6 Y 32
X 7 Y 32
X 8 Y 32
X 9 Y 32
X 10 Y 32
X 11 Y 32
X 12 Y 32
