X 31 Y 1
X 31 Y 2
X 32 Y 2
X 33 Y 2
X 34 Y 2
X 35 Y 2
