X 8 Y 9
X 9 Y 9
X 9 Y 8
X 9 Y 7
X 10 Y 7
X 11 Y 7
X 12 Y 7
X 13 Y 7
X 13 Y 6
X 13 Y 5
X 13 Y 4
