0000000000000000000000000000000000000000
0000000000000000000000000000000000000000
0000000000000000000000000000000000000000
0000000000000000000000000000000000000000
0000000000000000000000000000000000000000
0000000000000000000000000000000000000000
0000000000000000000000000000000000000000
0000000000000000000000000000000000000000
0000000000000000000000000000000000000000
1110000000000000000000000000000000000000
1110000000000000000000000000000000001100
1111111111000000000000000000000000001100
11100000000$1111111111111111100000001100
1110000000011111111111111111110000001100
11100000$$001111111111111111111000001100
1110000011001110000000000001111100001100
1110001000001110000000000000111110001100
1110@0100000111X000000000000000000001100
1111111111111111111111111111111111111100
1111111111111111111111111111111111111100
0000000000000000000000000000000000000000
0000000000000000000000000000000000000000
0000000000000000000000000000000000000000
0000000000000000000000000000000000000000
0000000000000000000000000000000000000000
0000000000000000000000000000000000000000
0000000000000000000000000000000000000000
0000000000000000000000000000000000000000
0000000000000000000000000000000000000000
0000000000000000000000000000000000000000
0000000000000000000000000000000000000000
0000000000000000000000000000000000000000
ANONYMOUS
CAVE
4
4
4
NONE
2


0